#..##########
#......#....#
............#
#............
#####........